tip_lable	Group
Aquco	Basal_Eudicots
AUGV	Basal_Eudicots
BEKN	Basal_Eudicots
CCID	Basal_Eudicots
EVOD	Basal_Eudicots
GBVZ	Basal_Eudicots
IRAF	Basal_Eudicots
NMGG	Basal_Eudicots
QTJY	Basal_Eudicots
UDHA	Basal_Eudicots
UPOG	Basal_Eudicots
VGHH	Basal_Eudicots
WFBF	Basal_Eudicots
XHKT	Basal_Eudicots
XMVD	Basal_Eudicots
YHFG	Basal_Eudicots
ZGQD	Basal_Eudicots
IWMW	Basal_Eudicots
FAKD	Basal_Eudicots
GRRW	Basal_Eudicots
RQUG	Basal_Eudicots
VQFW	Basal_Eudicots
SWOH	Basal_Eudicots
AALA	Basal_Eudicots
EHNF	Dilleniales
XMQO	Basal_Eudicots
BSEY	Santalales
QKMG	Santalales
RSPO	Santalales
VGVI	Santalales
XGFU	Santalales
XKPS	Santalales
HAEU	Berberidopsidales
QUTB	Berberidopsidales
Betvu	Caryophyllales
AAXJ	Caryophyllales
AZBL	Caryophyllales
BERS	Caryophyllales
BJKT	Caryophyllales
BKQU	Caryophyllales
BWRK	Caryophyllales
BYNZ	Caryophyllales
CPKP	Caryophyllales
CTYH	Caryophyllales
CUTE	Caryophyllales
CVDF	Caryophyllales
DVXD	Caryophyllales
EDIT	Caryophyllales
FYSJ	Caryophyllales
FZQN	Caryophyllales
GIWN	Caryophyllales
GJNX	Caryophyllales
HDSY	Caryophyllales
JAFJ	Caryophyllales
JGAB	Caryophyllales
JLOV	Caryophyllales
KJAA	Caryophyllales
LKKX	Caryophyllales
OLES	Caryophyllales
OMYK	Caryophyllales
RUUB	Caryophyllales
RXEN	Caryophyllales
SFKQ	Caryophyllales
SHEZ	Caryophyllales
SKNL	Caryophyllales
SMMC	Caryophyllales
TJES	Caryophyllales
VJPU	Caryophyllales
WGET	Caryophyllales
WMLW	Caryophyllales
WOBD	Caryophyllales
WQUF	Caryophyllales
YNFJ	Caryophyllales
AJFN	Apiales
CWYJ	Apiales
EDBB	Apiales
MVSE	Apiales
NTEO	Apiales
OINM	Apiales
SBZH	Apiales
SUVN	Apiales
TQKZ	Apiales
WEQK	Apiales
ASMV	Aquifoliales
QACK	Aquifoliales
AFQQ	Asterales
AQZD	Asterales
AUIP	Asterales
BMSE	Asterales
CFRN	Asterales
DDRL	Asterales
DESP	Asterales
DOVJ	Asterales
DUNJ	Asterales
DUQG	Asterales
EYKJ	Asterales
FXGI	Asterales
GIOY	Asterales
GUMF	Asterales
HUQC	Asterales
IHPC	Asterales
IXVJ	Asterales
IZLO	Asterales
JNKW	Asterales
MHYG	Asterales
OAGK	Asterales
RFSD	Asterales
TEZA	Asterales
TPEM	Asterales
UBLN	Asterales
XRCX	Asterales
ABEH	Boraginales
DKFZ	Boraginales
EMAL	Boraginales
HANM	Boraginales
SMUR	Boraginales
YQIJ	Boraginales
BFJL	Cornales
FWBF	Cornales
QURC	Cornales
VTLJ	Cornales
VUSY	Cornales
ZETY	Cornales
CAQZ	Dipsacales
FFFY	Dipsacales
GSZA	Dipsacales
HLJG	Dipsacales
JTRM	Dipsacales
ZJRC	Dipsacales
ADHK	Ericales
AVJK	Ericales
AXBO	Ericales
BEFC	Ericales
BNTL	Ericales
DAAD	Ericales
FNEN	Ericales
HUSX	Ericales
JEXA	Ericales
JPDJ	Ericales
KVFU	Ericales
LRTN	Ericales
NGRR	Ericales
OXYP	Ericales
PPPZ	Ericales
PTFA	Ericales
QAUE	Ericales
SERM	Ericales
VKJD	Ericales
WRPP	Ericales
YSRZ	Ericales
CLMX	Escalloniales
GIPR	Garryales
SZUO	Garryales
DSUV	Gentianales
ECTD	Gentianales
EDEQ	Gentianales
GGJD	Gentianales
HGSM	Gentianales
JCLQ	Gentianales
JGYZ	Gentianales
KPUM	Gentianales
KTWL	Gentianales
MGVU	Gentianales
PCNH	Gentianales
QEHE	Gentianales
UOYN	Gentianales
WQRD	Gentianales
QZZU	Icacinales
Mimgu	Lamiales
ATYL	Lamiales
AYIY	Lamiales
BAHE	Lamiales
CLRW	Lamiales
COBX	Lamiales
DCCI	Lamiales
DMLT	Lamiales
DTNC	Lamiales
EAAA	Lamiales
EDXZ	Lamiales
EJBY	Lamiales
EJCM	Lamiales
EQDA	Lamiales
FAMO	Lamiales
FDMM	Lamiales
FROP	Lamiales
FUMQ	Lamiales
FYUH	Lamiales
GCFE	Lamiales
GDZS	Lamiales
GETL	Lamiales
GNPX	Lamiales
GNRI	Lamiales
GRFT	Lamiales
HRUR	Lamiales
IYDF	Lamiales
JCMU	Lamiales
KTAR	Lamiales
LRRR	Lamiales
MQIV	Lamiales
MZLD	Lamiales
NBMW	Lamiales
OWAS	Lamiales
PCGJ	Lamiales
PHCE	Lamiales
PSHB	Lamiales
PTBJ	Lamiales
PUCW	Lamiales
RWKR	Lamiales
SIBR	Lamiales
SNNC	Lamiales
TAGM	Lamiales
TKEK	Lamiales
TORX	Lamiales
UCNM	Lamiales
UMUL	Lamiales
UTQR	Lamiales
VYDM	Lamiales
WEAC	Lamiales
WHNV	Lamiales
XAYK	Lamiales
XISJ	Lamiales
XMBA	Lamiales
XXYA	Lamiales
YZGX	Lamiales
ZRIN	Lamiales
Solly	Solanales
AHRN	Solanales
AIOU	Solanales
ALUC	Solanales
BOLZ	Solanales
CPOC	Solanales
JNVS	Solanales
LWCK	Solanales
MKZR	Solanales
UGJI	Solanales
CIAC	Saxifragales
CKKR	Saxifragales
CTSS	Saxifragales
DAYQ	Saxifragales
DRIL	Saxifragales
ERIA	Saxifragales
FCBJ	Saxifragales
FYTP	Saxifragales
HQRJ	Saxifragales
HTIP	Saxifragales
IUSR	Saxifragales
KWGC	Saxifragales
NUZN	Saxifragales
OOVX	Saxifragales
SLOI	Saxifragales
SYHW	Saxifragales
TOKV	Saxifragales
UHBY	Saxifragales
UWFU	Saxifragales
YKFU	Saxifragales
YKQR	Saxifragales
ZJUL	Saxifragales
Carpa	Rosids
Arath	Rosids
BXBF	Rosids
CRNC	Rosids
CSUV	Rosids
CZPV	Rosids
DZTK	Rosids
HYZL	Rosids
IPWB	Rosids
JOIS	Rosids
LVUS	Rosids
MYZV	Rosids
QSKP	Rosids
RTTY	Rosids
SWPE	Rosids
TZWR	Rosids
UAXP	Rosids
VMNH	Rosids
IHCQ	Rosids
MFEA	Rosids
PTLU	Rosids
VYGG	Rosids
AXAF	Rosids
NNGU	Rosids
OCTM	Rosids
CMFF	Rosids
GEHT	Rosids
HJMP	Rosids
JETM	Rosids
JTQQ	Rosids
KEGA	Rosids
KNMB	Rosids
KZED	Rosids
NXOH	Rosids
OHAE	Rosids
OQHZ	Rosids
QZXQ	Rosids
RKFX	Rosids
RKLL	Rosids
RMWJ	Rosids
SLYR	Rosids
SUAK	Rosids
TVSH	Rosids
VLNB	Rosids
XOOE	Rosids
ZSSR	Rosids
Phavu	Rosids
CWZU	Rosids
DXQW	Rosids
HENI	Rosids
INSP	Rosids
LNER	Rosids
LWDA	Rosids
NHUA	Rosids
SVVG	Rosids
TJLC	Rosids
HDWF	Rosids
YGCX	Rosids
WWKL	Rosids
AEPI	Rosids
BNDE	Rosids
CKDK	Rosids
COAQ	Rosids
EZZT	Rosids
FWCQ	Rosids
GLVK	Rosids
HBUQ	Rosids
LPGY	Rosids
NFXV	Rosids
PAZJ	Rosids
PXYR	Rosids
RPPC	Rosids
RVGH	Rosids
VNMY	Rosids
VVPY	Rosids
XNLP	Rosids
XPBC	Rosids
YGAT	Rosids
ZBVT	Rosids
ZTLR	Rosids
Poptr	Rosids
ATFX	Rosids
AWJM	Rosids
KPTE	Rosids
OLXF	Rosids
PKMO	Rosids
PUDI	Rosids
WMUK	Rosids
WYIG	Rosids
ZSAB	Rosids
Theca	Rosids
AJJE	Rosids
ARYD	Rosids
AYMT	Rosids
FEDW	Rosids
FGDU	Rosids
RJNQ	Rosids
SWGX	Rosids
WWQZ	Rosids
YNUE	Rosids
JHCN	Rosids
THHD	Rosids
TIUZ	Rosids
YZVJ	Rosids
ACFP	Rosids
AQGE	Rosids
BJSW	Rosids
BLVL	Rosids
CQMG	Rosids
DHAW	Rosids
EAVM	Rosids
EDHN	Rosids
EILE	Rosids
IANR	Rosids
KYAD	Rosids
NCVK	Rosids
QIEH	Rosids
QNOC	Rosids
RBYC	Rosids
SQCF	Rosids
SXCE	Rosids
TJQY	Rosids
VCIN	Rosids
WKCY	Rosids
XFFT	Rosids
XVJB	Rosids
ZHEE	Rosids
ZPKK	Rosids
BCAA	Rosids
FCCA	Rosids
HBHB	Rosids
IKFD	Rosids
JSZD	Rosids
OBTI	Rosids
QICX	Rosids
RJIM	Rosids
UHJR	Rosids
UVDC	Rosids
VFFP	Rosids
WAXR	Rosids
YUOM	Rosids
BBBA	Rosids
BGZG	Rosids
Vitvi	Rosids
KVAY	Rosids
UDUT	Rosids
ZHMB	Rosids
3439LA	Hydrostachyaceae
3442LA	Hydrostachyaceae
3445LA	Hydrostachyaceae
3446LA	Hydrostachyaceae
3449LA	Hydrostachyaceae
3451LA	Hydrostachyaceae
3453LA	Hydrostachyaceae
3462LA	Hydrostachyaceae
3473LA	Hydrostachyaceae
3481LA	Hydrostachyaceae
3483LA	Hydrostachyaceae
3487LA	Hydrostachyaceae